{	『
}	』
/	/

l,	‥
l.	…
l/	/
l;	:
l:	:
l'	"
l"	"
lh	←
lj	↓
lk	↑
ll	→

WW		W

q		そ
w		け
e		せ
r		て
t	ょ
y		つ
u	ん
i	の
o	を
p	り
a		は
s		か
d		し
f		と
g		た
h		く
j		う
k	い
l		l
;		き
'	な
z		す
x		こ
c	に
v		さ
b	あ
n	っ
m	る
,	、
.	。
/	れ

Q	ぁ
W		W
E		ほ
R		ふ
T	め
Y		ひ
U	え
I	み
O	や
P	ぬ
A	ぃ
S		へ
D	ら
F	ゅ
G	よ
H	ま
J	お
K	も
L	わ
:	ゆ
"		ち
Z	ぅ
X	ぇ
C	ぉ
V	ね
B	ゃ
N	む
M	ろ
<	・
>	ー
?	?

うl	ヴ
かl	が
きl	ぎ
くl	ぐ
けl	げ
こl	ご
さl	ざ
しl	じ
すl	ず
せl	ぜ
そl	ぞ
たl	だ
ちl	ぢ
つl	づ
てl	で
とl	ど
はl	ば
ひl	び
ふl	ぶ
へl	べ
ほl	ぼ
はW	ぱ
ひW	ぴ
ふW	ぷ
へW	ぺ
ほW	ぽ
